NO texture/dirt.xpm
SO texture/gold_ore.xpm
WE texture/iron_ore.xpm
EA texture/diamond_ore.xpm

F 220,100,0
C 225,30,0

1111111111111111111111111
1000000000110000000000001
1011000001110001000000001
1001000000000000100000001
1111111110110000011100001
1111111111111111111111111
1000000000110000000000001
1011000001110001000000001
1001000000000000100000001
1111111110110000011100001
1111111111111111111111111
1000000000110000000000001
1011000001110001000000001
100100000000000010N000001
1111111110110000011100001
1000000000110000011101111
1111011111111101110000001
1111011111111101110101001
1100000011010101110000001
1000000000000000110000001
1000000000000000110101001
1100000111010101111101111
11110111 1110101 10111101
11111111 1111111 11111111
11111
11011
11011
11111
